{
    "Level" : [
        [8,1,2,2,2,2,2,2,2,2,2,2,2,2,2,2,2,2,3,9],
        [8,0,0,0,0,0,0,0,0,0,0,0,0,0,0,0,0,0,0,9],
        [8,0,0,0,0,0,0,0,0,0,0,0,0,0,0,0,0,0,0,9],
        [8,0,0,0,0,0,0,0,0,0,0,0,0,0,0,0,0,0,0,9],
        [8,0,0,0,0,0,0,0,0,0,0,0,0,0,0,0,0,0,0,9],
        [8,0,0,0,0,0,0,0,0,0,0,0,0,0,0,0,0,0,0,9],
        [8,0,0,0,0,0,0,0,0,0,0,0,0,0,0,0,0,0,0,9],
        [8,0,0,0,0,0,0,0,0,0,0,0,0,0,0,0,0,0,0,9],
        [8,0,0,0,0,0,0,0,0,0,0,0,0,0,0,0,0,0,0,9],
        [8,0,0,0,0,0,0,0,0,0,0,0,0,0,0,0,0,0,0,9],
        [8,0,0,0,0,0,0,0,0,0,0,0,0,0,0,0,0,0,0,9],
        [8,0,0,0,0,0,0,0,0,0,0,0,0,0,0,0,0,0,0,9],
        [8,0,0,0,0,0,0,0,0,0,0,0,0,0,0,0,0,0,0,9],
        [8,0,0,0,0,0,0,0,0,0,0,0,0,0,0,0,0,0,0,9],
        [8,1,2,2,2,2,2,2,2,2,2,2,2,2,2,2,2,2,3,9]
    ]
}